+===.,,        .+=:://+
*+*] .=++**:==+++*!::!/
::*=,=/    !    ]. *]]!
+*+./ ]/**:::*:   : +++
==+] /.         ,  !=,,
=+  !     ,=.    = ]=+,
=!    ..,*+*      / /+=
.] !! ]  ]/+]*    .] . 
.  + .]/]=...:=    / * 
+ ].    +=..../    ! ! 
=] . + ,,+:., *, = =   
*]]...,+, *,] ,,,= = ] 
=  .*!+  ,!/!   .==+]] 
+] +,     ]/:.,  .,=/  
+  +,     :*.+.], .* !.
.  *       ,,=,//  ! !:
 / :     .,,+,, ]  ] :,
+* ].    ,, ++!/. +  :+
.+! /    +!] =.   ] ]::
*==  ! + //  ++ .!: !=]
!*:// ]*=+ ,  ,! ]!:+=:
:!!//:     /    ]::!=!!
]=:!  =*:/!!/!!::*/:!: 
!! =+*==+  **==,=:!]/ /
