*+*+@%#        ##*==--*
+++*#@+-  :-   +=**=--:
#*#%- :-**=++*+   =@###
*+=  #          @: :##%
*+  @ @@@**= @   @: -##
@: =-=- : -#=:@   @: # 
#::%  %**%@@@#=    = = 
*: %@# ##%=@# *%@* *  @
*  @%### @+=- @%#=#*   
*: ##@   @:-=%%  @#*:  
#  #@     #*@*@-* @+:=#
@  +     @%#*#*  @ - =%
** :%    %% ##-=@ * :+#
%#* :% %+: ++#@  #- :+:
=++-- :**#@#@@%= :=+**=
=-+-#%=   --     ==++=:
-- +#+*+*@@##*+#*==-::-
