+#-@#@@@% @#%=+-=
++#-::-----::+@*%
*+.+   %#@  @::##
#.-:-:::#:%  @:= 
+:#@@@#*%#=@@ =:@
+.#### *+:*%**+.%
+:*#   ++#%+ #+.@
%:=   @%##%.+ -:#
%*:+  @+:=#  =.-+
--:::-=#%#+-:=+*=
:=-%#**%##++-==-:
