=*=: .,        ,,=!:!/=
**:=, */  ]/   ::==!//]
+*+./ ]!==:**=:   : +++
=*!  +           ] ]+,,
=:       *=!      ] /,+
 ] !/!/ ] /+!]     ] , 
+]].  ,+=,...+!    ! : 
=] . + ,,,:., *, = =   
=   ,++, .*:/  .+:+=   
=] +,     ]/!.,  .,=]  
+  +.     +=.=./=  *]!+
   :      .,=++    / !,
== ],    ,. ++/!  + ]:+
.+= ], ,*] **,.  +/ ]*]
!*:// ]=++ +  .: ]!:+=:
:/*/+,!   //     :::*!]
/] :+*+*=. ++=*,=!!/]]/
