+#-@#@@@% @#%=+-=
++#-: -----  +@*%
*+ +   %#@  @::##
# -:-  :#:%  @ = 
+:#@@@#*%#=@@ = @
+ #### *+:*%**+ %
+ *#   ++#%+ #+ @
% =   @%##% + -:#
%* +  @+ =#  = -+
--:::-=#%#+- =+*=
 =-%#**%##++-==-:
